360ONE: 360 ONE WAM Ltd.
3MINDIA: 3M India Ltd.
AADHARHFC: Aadhar Housing Finance Ltd.
AARTIIND: Aarti Industries Ltd.
AAVAS: Aavas Financiers Ltd.
ABB: ABB India Ltd.
ABBOTINDIA: Abbott India Ltd.
ABCAPITAL: Aditya Birla Capital Ltd.
ABFRL: Aditya Birla Fashion and Retail Ltd.
ABREL: Aditya Birla Real Estate Ltd.
ABSLAMC: Aditya Birla Sun Life AMC Ltd.
ACC: ACC Ltd.
ACE: Action Construction Equipment Ltd.
ACI: Archean Chemical Industries Ltd.
ADANIENSOL: Adani Energy Solutions Ltd.
ADANIENT: Adani Enterprises Ltd.
ADANIGREEN: Adani Green Energy Ltd.
ADANIPORTS: Adani Ports and Special Economic Zone Ltd.
ADANIPOWER: Adani Power Ltd.
AEGISLOG: Aegis Logistics Ltd.
AFFLE: Affle (India) Ltd.
AIAENG: AIA Engineering Ltd.
AJANTPHARM: Ajanta Pharma Ltd.
AKUMS: Akums Drugs & Pharmaceuticals Ltd.
ALKEM: Alkem Laboratories Ltd.
ALKYLAMINE: Alkyl Amines Chemicals Ltd.
ALOKINDS: Alok Industries Ltd.
AMBER: Amber Enterprises India Ltd.
AMBUJACEM: Ambuja Cements Ltd.
ANANDRATHI: Anand Rathi Wealth Ltd.
ANANTRAJ: Anant Raj Ltd.
ANGELONE: Angel One Ltd.
APARINDS: Apar Industries Ltd.
APLAPOLLO: APL Apollo Tubes Ltd.
APLLTD: APL Apollo Tubes Ltd.
APOLLOHOSP: Apollo Hospitals Enterprise Ltd.
APOLLOTYRE: Apollo Tyres Ltd.
APTUS: Aptus Value Housing Finance India Ltd.
ARE&M: Amara Raja Energy & Mobility Ltd.
ARE_M: Amara Raja Energy & Mobility Ltd.
ASAHIINDIA: Asahi India Glass Ltd.
ASHOKLEY: Ashok Leyland Ltd.
ASIANPAINT: Asian Paints Ltd.
ASTERDM: Aster DM Healthcare Ltd.
ASTRAL: Astral Ltd.
ASTRAZEN: AstraZeneca Pharma India Ltd.
ATGL: Adani Total Gas Ltd.
ATUL: Atul Ltd.
AUBANK: AU Small Finance Bank Ltd.
AUROPHARMA: Aurobindo Pharma Ltd.
AVANTIFEED: Avanti Feeds Ltd.
AWL: Adani Wilmar Ltd.
AXISBANK: Axis Bank Ltd.
BAJAJ-AUTO: Bajaj Auto Ltd.
BAJAJFINSV: Bajaj Finserv Ltd.
BAJAJHLDNG: Bajaj Holdings & Investment Ltd.
BAJFINANCE: Bajaj Finance Ltd.
BALAMINES: Balaji Amines Ltd.
BALKRISIND: Balkrishna Industries Ltd.
BALRAMCHIN: Balrampur Chini Mills Ltd.
BANDHANBNK: Bandhan Bank Ltd.
BANKBARODA: Bank of Baroda
BANKINDIA: Bank of India
BASF: BASF India Ltd.
BATAINDIA: Bata India Ltd.
BAYERCROP: Bayer CropScience Ltd.
BBTC: Bombay Burmah Trading Corporation Ltd.
BDL: Bharat Dynamics Ltd.
BEL: Bharat Electronics Ltd.
BEML: BEML Ltd.
BERGEPAINT: Berger Paints India Ltd.
BHARATFORG: Bharat Forge Ltd.
BHARTIARTL: Bharti Airtel Ltd.
BHARTIHEXA: Bharti Hexacom Ltd.
BHEL: Bharat Heavy Electricals Ltd.
BIKAJI: Bikaji Foods International Ltd.
BIOCON: Biocon Ltd.
BIRLACORPN: Birla Corporation Ltd.
BLS: BLS International Services Ltd.
BLUEDART: Blue Dart Express Ltd.
BLUESTARCO: Blue Star Ltd.
BOSCHLTD: Bosch Ltd.
BPCL: Bharat Petroleum Corporation Ltd.
BRIGADE: Brigade Enterprises Ltd.
BRITANNIA: Britannia Industries Ltd.
BSE: BSE Ltd.
BSOFT: Birlasoft Ltd.
CAMPUS: Campus Activewear Ltd.
CAMS: Computer Age Management Services Ltd.
CANBK: Canara Bank
CANFINHOME: Can Fin Homes Ltd.
CAPLIPOINT: Caplin Point Laboratories Ltd.
CARBORUNIV: Carborundum Universal Ltd.
CASTROLIND: Castrol India Ltd.
CCL: CCL Products (India) Ltd.
CDSL: Central Depository Services (India) Ltd.
CEATLTD: CEAT Ltd.
CELLO: Cello World Ltd.
CENTRALBK: Central Bank of India
CENTURYPLY: Century Plyboards (India) Ltd.
CERA: Cera Sanitaryware Ltd.
CESC: CESC Ltd.
CGCL: Capri Global Capital Ltd.
CGPOWER: CG Power and Industrial Solutions Ltd.
CHALET: Chalet Hotels Ltd.
CHAMBLFERT: Chambal Fertilizers & Chemicals Ltd.
CHEMPLASTS: Chemplast Sanmar Ltd.
CHENNPETRO: Chennai Petroleum Corporation Ltd.
CHOLAFIN: Cholamandalam Investment and Finance Company Ltd.
CHOLAHLDNG: Cholamandalam Financial Holdings Ltd.
CIEINDIA: CIE Automotive India Ltd.
CIPLA: Cipla Ltd.
CLEAN: Clean Science and Technology Ltd.
COALINDIA: Coal India Ltd.
COCHINSHIP: Cochin Shipyard Ltd.
COFORGE: Coforge Ltd.
COLPAL: Colgate-Palmolive (India) Ltd.
CONCOR: Container Corporation of India Ltd.
CONCORDBIO: Concord Biotech Ltd.
COROMANDEL: Coromandel International Ltd.
CRAFTSMAN: Craftsman Automation Ltd.
CREDITACC: CreditAccess Grameen Ltd.
CRISIL: CRISIL Ltd.
CROMPTON: Crompton Greaves Consumer Electricals Ltd.
CUB: City Union Bank Ltd.
CUMMINSIND: Cummins India Ltd.
CYIENT: Cyient Ltd.
DABUR: Dabur India Ltd.
DALBHARAT: Dalmia Bharat Ltd.
DATAPATTNS: Data Patterns (India) Ltd.
DBREALTY: DB Realty Ltd.
DEEPAKFERT: Deepak Fertilisers and Petrochemicals Corporation Ltd.
DEEPAKNTR: Deepak Nitrite Ltd.
DELHIVERY: Delhivery Ltd.
DEVYANI: Devyani International Ltd.
DIVISLAB: Divi's Laboratories Ltd.
DIXON: Dixon Technologies (India) Ltd.
DLF: DLF Ltd.
DMART: Avenue Supermarts Ltd.
DOMS: DOMS Industries Ltd.
DRREDDY: Dr. Reddy's Laboratories Ltd.
EASEMYTRIP: Easy Trip Planners Ltd.
ECLERX: eClerx Services Ltd.
EICHERMOT: Eicher Motors Ltd.
EIDPARRY: EID Parry (India) Ltd.
EIHOTEL: EIH Ltd.
ELECON: Elecon Engineering Company Ltd.
ELGIEQUIP: Elgi Equipments Ltd.
EMAMILTD: Emami Ltd.
EMCURE: Emcure Pharmaceuticals Ltd.
ENDURANCE: Endurance Technologies Ltd.
ENGINERSIN: Engineers India Ltd.
EQUITASBNK: Equitas Small Finance Bank Ltd.
ERIS: Eris Lifesciences Ltd.
ESCORTS: Escorts Kubota Ltd.
EXIDEIND: Exide Industries Ltd.
FACT: Fertilisers and Chemicals Travancore Ltd.
FEDERALBNK: The Federal Bank Ltd.
FINCABLES: Finolex Cables Ltd.
FINEORG: Fine Organic Industries Ltd.
FINPIPE: Finolex Industries Ltd.
FIVESTAR: Five-Star Business Finance Ltd.
FLUOROCHEM: Gujarat Fluorochemicals Ltd.
FORTIS: Fortis Healthcare Ltd.
FSL: Firstsource Solutions Ltd.
GAEL: Gujarat Ambuja Exports Ltd.
GAIL: GAIL (India) Ltd.
GESHIP: Great Eastern Shipping Company Ltd.
GICRE: General Insurance Corporation of India
GILLETTE: Gillette India Ltd.
GLAND: Gland Pharma Ltd.
GLAXO: GlaxoSmithKline Pharmaceuticals Ltd.
GLENMARK: Glenmark Pharmaceuticals Ltd.
GMDCLTD: Gujarat Mineral Development Corporation Ltd.
GMRAIRPORT: GMR Airports Infrastructure Ltd.
GNFC: Gujarat Narmada Valley Fertilizers & Chemicals Ltd.
GODFRYPHLP: Godfrey Phillips India Ltd.
GODIGIT: Go Digit General Insurance Ltd.
GODREJAGRO: Godrej Agrovet Ltd.
GODREJCP: Godrej Consumer Products Ltd.
GODREJIND: Godrej Industries Ltd.
GODREJPROP: Godrej Properties Ltd.
GPIL: Godawari Power & Ispat Ltd.
GPPL: Gujarat Pipavav Port Ltd.
GRANULES: Granules India Ltd.
GRAPHITE: Graphite India Ltd.
GRASIM: Grasim Industries Ltd.
GRINDWELL: Grindwell Norton Ltd.
GRINFRA: G R Infraprojects Ltd.
GRSE: Garden Reach Shipbuilders & Engineers Ltd.
GSFC: Gujarat State Fertilizers & Chemicals Ltd.
GSPL: Gujarat State Petronet Ltd.
GUJGASLTD: Gujarat Gas Ltd.
GVT&D: GE T&D India Ltd.
GVT_D: GE T&D India Ltd.
HAL: Hindustan Aeronautics Ltd.
HAPPSTMNDS: Happiest Minds Technologies Ltd.
HAVELLS: Havells India Ltd.
HBLENGINE: HBL Power Systems Ltd.
HCLTECH: HCL Technologies Ltd.
HDFCAMC: HDFC Asset Management Company Ltd.
HDFCBANK: HDFC Bank Ltd.
HDFCLIFE: HDFC Life Insurance Company Ltd.
HEG: HEG Ltd.
HEROMOTOCO: Hero MotoCorp Ltd.
HFCL: HFCL Ltd.
HINDALCO: Hindalco Industries Ltd.
HINDCOPPER: Hindustan Copper Ltd.
HINDPETRO: Hindustan Petroleum Corporation Ltd.
HINDUNILVR: Hindustan Unilever Ltd.
HINDZINC: Hindustan Zinc Ltd.
HOMEFIRST: Home First Finance Company India Ltd.
HONASA: Honasa Consumer Ltd.
HONAUT: Honeywell Automation India Ltd.
HSCL: Himadri Speciality Chemical Ltd.
HUDCO: Housing and Urban Development Corporation Ltd.
ICICIBANK: ICICI Bank Ltd.
ICICIGI: ICICI Lombard General Insurance Company Ltd.
ICICIPRULI: ICICI Prudential Life Insurance Company Ltd.
IDBI: IDBI Bank Ltd.
IDEA: Vodafone Idea Ltd.
IDFCFIRSTB: IDFC First Bank Ltd.
IEX: Indian Energy Exchange Ltd.
IFCI: IFCI Ltd.
IGL: Indraprastha Gas Ltd.
IIFL: IIFL Finance Ltd.
INDGN: Indegene Ltd.
INDHOTEL: The Indian Hotels Company Ltd.
INDIACEM: The India Cements Ltd.
INDIAMART: IndiaMART InterMESH Ltd.
INDIANB: Indian Bank
INDIGO: InterGlobe Aviation Ltd.
INDUSINDBK: IndusInd Bank Ltd.
INDUSTOWER: Indus Towers Ltd.
INFY: Infosys Ltd.
INOXINDIA: INOX India Ltd.
INOXWIND: Inox Wind Ltd.
INTELLECT: Intellect Design Arena Ltd.
IOB: Indian Overseas Bank
IOC: Indian Oil Corporation Ltd.
IPCALAB: Ipca Laboratories Ltd.
IRB: IRB Infrastructure Developers Ltd.
IRCON: Ircon International Ltd.
IRCTC: Indian Railway Catering and Tourism Corporation Ltd.
IREDA: Indian Renewable Energy Development Agency Ltd.
IRFC: Indian Railway Finance Corporation Ltd.
ITC: ITC Ltd.
ITI: ITI Ltd.
J&KBANK: The Jammu & Kashmir Bank Ltd.
JBCHEPHARM: J.B. Chemicals & Pharmaceuticals Ltd.
JBMA: JBM Auto Ltd.
JINDALSAW: Jindal Saw Ltd.
JINDALSTEL: Jindal Steel & Power Ltd.
JIOFIN: Jio Financial Services Ltd.
JKCEMENT: JK Cement Ltd.
JKLAKSHMI: JK Lakshmi Cement Ltd.
JKTYRE: JK Tyre & Industries Ltd.
JMFINANCIL: JM Financial Ltd.
JPPOWER: Jaiprakash Power Ventures Ltd.
JSL: Jindal Stainless Ltd.
JSWENERGY: JSW Energy Ltd.
JSWINFRA: JSW Infrastructure Ltd.
JSWSTEEL: JSW Steel Ltd.
JUBLFOOD: Jubilant FoodWorks Ltd.
JUBLINGREA: Jubilant Ingrevia Ltd.
JUBLPHARMA: Jubilant Pharmova Ltd.
JUSTDIAL: Just Dial Ltd.
JWL: Jupiter Wagons Ltd.
JYOTHYLAB: Jyothy Labs Ltd.
JYOTICNC: Jyoti CNC Automation Ltd.
J_KBANK: The Jammu & Kashmir Bank Ltd.
KAJARIACER: Kajaria Ceramics Ltd.
KALYANKJIL: Kalyan Jewellers India Ltd.
KANSAINER: Kansai Nerolac Paints Ltd.
KARURVYSYA: Karur Vysya Bank Ltd.
KAYNES: Kaynes Technology India Ltd.
KEC: KEC International Ltd.
KEI: KEI Industries Ltd.
KFINTECH: KFin Technologies Ltd.
KIMS: Krishna Institute of Medical Sciences Ltd.
KIRLOSBROS: Kirloskar Brothers Ltd.
KIRLOSENG: Kirloskar Oil Engines Ltd.
KNRCON: KNR Constructions Ltd.
KOTAKBANK: Kotak Mahindra Bank Ltd.
KPIL: Kalpataru Projects International Ltd.
KPITTECH: KPIT Technologies Ltd.
KPRMILL: K.P.R. Mill Ltd.
KSB: KSB Ltd.
LALPATHLAB: Dr. Lal PathLabs Ltd.
LATENTVIEW: Latent View Analytics Ltd.
LAURUSLABS: Laurus Labs Ltd.
LEMONTREE: Lemon Tree Hotels Ltd.
LICHSGFIN: LIC Housing Finance Ltd.
LICI: Life Insurance Corporation of India
LINDEINDIA: Linde India Ltd.
LLOYDSME: Lloyds Metals and Energy Ltd.
LODHA: Macrotech Developers Ltd.
LT: Larsen & Toubro Ltd.
LTF: L&T Finance Ltd.
LTIM: LTIMindtree Ltd.
LTTS: L&T Technology Services Ltd.
LUPIN: Lupin Ltd.
M&M: Mahindra & Mahindra Ltd.
M&MFIN: Mahindra & Mahindra Financial Services Ltd.
MAHABANK: Bank of Maharashtra
MAHLIFE: Mahindra Lifespace Developers Ltd.
MAHSEAMLES: Maharashtra Seamless Ltd.
MANAPPURAM: Manappuram Finance Ltd.
MANKIND: Mankind Pharma Ltd.
MANYAVAR: Vedant Fashions Ltd.
MAPMYINDIA: C.E. Info Systems Ltd.
MARICO: Marico Ltd.
MARUTI: Maruti Suzuki India Ltd.
MASTEK: Mastek Ltd.
MAXHEALTH: Max Healthcare Institute Ltd.
MAZDOCK: Mazagon Dock Shipbuilders Ltd.
MCX: Multi Commodity Exchange of India Ltd.
MEDANTA: Global Health Ltd.
METROBRAND: Metro Brands Ltd.
METROPOLIS: Metropolis Healthcare Ltd.
MFSL: Max Financial Services Ltd.
MGL: Mahanagar Gas Ltd.
MINDACORP: Minda Corporation Ltd.
MMTC: MMTC Ltd.
MOTHERSON: Samvardhana Motherson International Ltd.
MOTILALOFS: Motilal Oswal Financial Services Ltd.
MPHASIS: Mphasis Ltd.
MRF: MRF Ltd.
MRPL: Mangalore Refinery and Petrochemicals Ltd.
MSUMI: Samvardhana Motherson International Ltd.
MUTHOOTFIN: Muthoot Finance Ltd.
M_M: Mahindra & Mahindra Ltd.
M_MFIN: Mahindra & Mahindra Financial Services Ltd.
NAM-INDIA: Nippon Life India Asset Management Ltd.
NATCOPHARM: Natco Pharma Ltd.
NATIONALUM: National Aluminium Company Ltd.
NAUKRI: Info Edge (India) Ltd.
NAVINFLUOR: Navin Fluorine International Ltd.
NBCC: NBCC (India) Ltd.
NCC: NCC Ltd.
NESTLEIND: Nestle India Ltd.
NETWEB: Netweb Technologies India Ltd.
NETWORK18: Network18 Media & Investments Ltd.
NEWGEN: Newgen Software Technologies Ltd.
NH: Narayana Hrudayalaya Ltd.
NHPC: NHPC Ltd.
NIACL: The New India Assurance Company Ltd.
NLCINDIA: NLC India Ltd.
NMDC: NMDC Ltd.
NSLNISP: NSL Group Entity (Specific name unclear / Potentially delisted)
NTPC: NTPC Ltd.
NUVAMA: Nuvama Wealth Management Ltd.
NUVOCO: Nuvoco Vistas Corporation Ltd.
NYKAA: FSN E-Commerce Ventures Ltd.
OBEROIRLTY: Oberoi Realty Ltd.
OFSS: Oracle Financial Services Software Ltd.
OIL: Oil India Ltd.
OLECTRA: Olectra Greentech Ltd.
ONGC: Oil and Natural Gas Corporation Ltd.
PAGEIND: Page Industries Ltd.
PATANJALI: Patanjali Foods Ltd.
PAYTM: One97 Communications Ltd.
PCBL: PCBL Ltd.
PEL: Piramal Enterprises Ltd.
PERSISTENT: Persistent Systems Ltd.
PETRONET: Petronet LNG Ltd.
PFC: Power Finance Corporation Ltd.
PFIZER: Pfizer Ltd.
PGHH: Procter & Gamble Hygiene and Health Care Ltd.
PHOENIXLTD: The Phoenix Mills Ltd.
PIDILITIND: Pidilite Industries Ltd.
PIIND: PI Industries Ltd.
PNB: Punjab National Bank
PNBHOUSING: PNB Housing Finance Ltd.
PNCINFRA: PNC Infratech Ltd.
POLICYBZR: PB Fintech Ltd.
POLYCAB: Polycab India Ltd.
POLYMED: Poly Medicure Ltd.
POONAWALLA: Poonawalla Fincorp Ltd.
POWERGRID: Power Grid Corporation of India Ltd.
POWERINDIA: Hitachi Energy India Ltd.
PPLPHARMA: Piramal Pharma Ltd.
PRAJIND: Praj Industries Ltd.
PRESTIGE: Prestige Estates Projects Ltd.
PTCIL: PTC India Ltd.
PVRINOX: PVR INOX Ltd.
QUESS: Quess Corp Ltd.
RADICO: Radico Khaitan Ltd.
RAILTEL: RailTel Corporation of India Ltd.
RAINBOW: Rainbow Children's Medicare Ltd.
RAJESHEXPO: Rajesh Exports Ltd.
RAMCOCEM: The Ramco Cements Ltd.
RATNAMANI: Ratnamani Metals & Tubes Ltd.
RAYMOND: Raymond Ltd.
RAYMONDLSL: Raymond Ltd.
RBLBANK: RBL Bank Ltd.
RCF: Rashtriya Chemicals and Fertilizers Ltd.
RECLTD: REC Ltd.
REDINGTON: Redington Ltd.
RELIANCE: Reliance Industries Ltd.
RENUKA: Shree Renuka Sugars Ltd.
RHIM: RHI Magnesita India Ltd.
RITES: RITES Ltd.
RKFORGE: Ramkrishna Forgings Ltd.
ROUTE: Route Mobile Ltd.
RRKABEL: R R Kabel Ltd.
RTNINDIA: RattanIndia Enterprises Ltd.
RVNL: Rail Vikas Nigam Ltd.
SAIL: Steel Authority of India Ltd.
SAMMAANCAP: Sammaan Capital Ltd.
SANOFI: Sanofi India Ltd.
SAPPHIRE: Sapphire Foods India Ltd.
SAREGAMA: Saregama India Ltd.
SBFC: SBFC Finance Ltd.
SBICARD: SBI Cards and Payment Services Ltd.
SBILIFE: SBI Life Insurance Company Ltd.
SBIN: State Bank of India
SCHAEFFLER: Schaeffler India Ltd.
SCHNEIDER: Schneider Electric Infrastructure Ltd.
SCI: Shipping Corporation of India Ltd.
SHREECEM: Shree Cement Ltd.
SHRIRAMFIN: Shriram Finance Ltd.
SHYAMMETL: Shyam Metalics and Energy Ltd.
SIEMENS: Siemens Ltd.
SIGNATURE: Signatureglobal (India) Ltd.
SJVN: SJVN Ltd.
SKFINDIA: SKF India Ltd.
SOBHA: Sobha Ltd.
SOLARINDS: Solar Industries India Ltd.
SONACOMS: Sona BLW Precision Forgings Ltd.
SONATSOFTW: Sonata Software Ltd.
SPARC: Sun Pharma Advanced Research Company Ltd.
SRF: SRF Ltd.
STARHEALTH: Star Health and Allied Insurance Company Ltd.
SUMICHEM: Sumitomo Chemical India Ltd.
SUNDARMFIN: Sundaram Finance Ltd.
SUNDRMFAST: Sundram Fasteners Ltd.
SUNPHARMA: Sun Pharmaceutical Industries Ltd.
SUNTV: Sun TV Network Ltd.
SUPREMEIND: Supreme Industries Ltd.
SUVENPHAR: Suven Pharmaceuticals Ltd.
SUZLON: Suzlon Energy Ltd.
SWANENERGY: Swan Energy Ltd.
SWSOLAR: Sterling and Wilson Renewable Energy Ltd.
SYNGENE: Syngene International Ltd.
SYRMA: Syrma SGS Technology Ltd.
TANLA: Tanla Platforms Ltd.
TATACHEM: Tata Chemicals Ltd.
TATACOMM: Tata Communications Ltd.
TATACONSUM: Tata Consumer Products Ltd.
TATAELXSI: Tata Elxsi Ltd.
TATAINVEST: Tata Investment Corporation Ltd.
TATAMOTORS: Tata Motors Ltd.
TATAPOWER: Tata Power Company Ltd.
TATASTEEL: Tata Steel Ltd.
TATATECH: Tata Technologies Ltd.
TBOTEK: TBO Tek Ltd.
TCS: Tata Consultancy Services Ltd.
TECHM: Tech Mahindra Ltd.
TECHNOE: Techno Electric & Engineering Company Ltd.
TEJASNET: Tejas Networks Ltd.
THERMAX: Thermax Ltd.
TIINDIA: Tube Investments of India Ltd.
TIMKEN: Timken India Ltd.
TITAGARH: Titagarh Rail Systems Ltd.
TITAN: Titan Company Ltd.
TORNTPHARM: Torrent Pharmaceuticals Ltd.
TORNTPOWER: Torrent Power Ltd.
TRENT: Trent Ltd.
TRIDENT: Trident Ltd.
TRITURBINE: Triveni Turbine Ltd.
TRIVENI: Triveni Engineering & Industries Ltd.
TTML: Tata Teleservices (Maharashtra) Ltd.
TVSMOTOR: TVS Motor Company Ltd.
TVSSCS: TVS Supply Chain Solutions Ltd.
UBL: United Breweries Ltd.
UCOBANK: UCO Bank
UJJIVANSFB: Ujjivan Small Finance Bank Ltd.
ULTRACEMCO: UltraTech Cement Ltd.
UNIONBANK: Union Bank of India
UNITDSPR: United Spirits Ltd.
UNOMINDA: Uno Minda Ltd.
UPL: UPL Ltd.
USHAMART: Usha Martin Ltd.
UTIAMC: UTI Asset Management Company Ltd.
VARROC: Varroc Engineering Ltd.
VBL: Varun Beverages Ltd.
VEDL: Vedanta Ltd.
VGUARD: V-Guard Industries Ltd.
VIJAYA: Vijaya Diagnostic Centre Ltd.
VINATIORGA: Vinati Organics Ltd.
VIPIND: VIP Industries Ltd.
VOLTAS: Voltas Ltd.
VTL: Vardhman Textiles Ltd.
WELCORP: Welspun Corp Ltd.
WELSPUNLIV: Welspun Living Ltd.
WESTLIFE: Westlife Foodworld Ltd.
WHIRLPOOL: Whirlpool of India Ltd.
WIPRO: Wipro Ltd.
YESBANK: Yes Bank Ltd.
ZEEL: Zee Entertainment Enterprises Ltd.
ZENSARTECH: Zensar Technologies Ltd.
ZFCVINDIA: ZF Commercial Vehicle Control Systems India Ltd.
ZOMATO: Zomato Ltd.
ZYDUSLIFE: Zydus Lifesciences Ltd.